norvig_corrector	../data/norvig_model_wmt.bin
nnseval	../data/paetzold_nns_dataset.txt
eng_caretro_embeddings	../data/english_vectors_phrases_tagged_1300_cbow_retrofitted.bin
eng_typical_embeddings	../data/english_vectors_300_cbow_retrofitted.bin
newsela_candidates	../data/newsela_candidates.txt
eng_ls_dataset_nodemo	../data/surveymonkey_LS_dataset_victor_nodemo.txt
eng_ls_dataset_withdemo	../data/surveymonkey_LS_dataset_victor_withdemo.txt
eng_ranker_model	../data/eng_ranker_model.pkl
eng_ranker_demofarm	../data/eng_ranker_demofarm.pkl
eng_sub_lm	../data/english_subimdb_lm.bin
eng_sub_shelf	../data/english_frequency_shelf.bin
eng_mean_freq	92548.493947
eng_std_freq	288581.810434
eng_min_proportion	64.0
eng_hard_simps	../data/english_hard_simplifications.txt
eng_irreplaceable	../data/english_irreplaceable.txt
eng_prohibited_phrase_edges	../data/english_prohibited_phrase_edges.txt
eng_prohibited_phrase_chars	../data/english_prohibited_phrase_chars.txt
nn_sr_model	../data/RegressionParallelNN_HIDDEN=8_LAYERS=4
gal_typical_embeddings	../data/galician_vectors_300_cbow.bin
gal_careretro_embeddings	../data/galician_vectors_tagged_300_cbow.bin
gal_lm	../data/galician_lm.bin
ita_typical_embeddings	../data/italian_vectors_500_cbow.bin
ita_careretro_embeddings	../data/italian_w2vmodel_tagged_generalized_300_cbow.bin
ita_lm	../data/italian_lm.bin
spa_typical_embeddings	../data/spanish_vectors_500_cbow.bin
spa_caretro_embeddings	../data/spanish_w2vmodel_tagged_generalized_1300_cbow.bin
spa_lm	../data/spanish_lm.bin
true_en	../data/distributions.obj
true_es	../data/distributions.es.obj
true_gl	../data/distributions.gl.obj
prop_en	../data/english.myproperties.properties
prop_es	../data/spanish.myproperties.properties
prop_gl	../data/galician.myproperties.properties
corenlp_dir	../data/stanford-corenlp-full-2016-10-31
spanish_ubr	../data/spanish_dataset_ubr.txt
galician_ubr	../data/galician_dataset_ubr.txt
italian_ubr	../data/italian_dataset_ubr.txt
comp_model_en	../data/complex_classifier/en/model.pkl
comp_model_es	../data/complex_classifier/es/model.pkl
comp_model_it	../data/complex_classifier/it/model.pkl
conf_model_en	../data/confidence_model/en/model.pkl
lm_en	../data/training_full.blm.en
true_it	../data/distributions.it.obj
prop_it	../data/italian.myproperties.properties
hardcoding	../data/hardcoding
