norvig_corrector	/app/data/data/norvig_model_wmt.bin
nnseval	/app/data/data/paetzold_nns_dataset.txt
eng_caretro_embeddings	/app/data/data/english_vectors_phrases_tagged_1300_cbow_retrofitted.bin
eng_typical_embeddings	/app/data/data/english_vectors_300_cbow_retrofitted.bin
newsela_candidates	/app/data/data/newsela_candidates.txt
eng_sub_lm	/app/data/data/english_subimdb_lm.bin
eng_sub_shelf	/app/data/data/english_frequency_shelf.bin
eng_mean_freq	92548.493947
eng_std_freq	288581.810434
eng_min_proportion	64.0
eng_hard_simps	/app/data/data/english_hard_simplifications.txt
eng_irreplaceable	/app/data/data/english_irreplaceable.txt
eng_prohibited_phrase_edges	/app/data/data/english_prohibited_phrase_edges.txt
eng_prohibited_phrase_chars	/app/data/data/english_prohibited_phrase_chars.txt
nn_sr_model	/app/data/data/RegressionParallelNN_HIDDEN=8_LAYERS=4
gal_typical_embeddings	/app/data/data/galician_vectors_300_cbow.bin
gal_careretro_embeddings	/app/data/data/galician_vectors_tagged_300_cbow.bin
gal_lm	/app/data/data/galician_lm.bin
ita_typical_embeddings	/app/data/data/italian_vectors_500_cbow.bin
ita_careretro_embeddings	/app/data/data/italian_w2vmodel_tagged_generalized_300_cbow.bin
ita_lm	/app/data/data/italian_lm.bin
spa_typical_embeddings	/app/data/data/spanish_vectors_500_cbow.bin
spa_caretro_embeddings	/app/data/data/spanish_w2vmodel_tagged_generalized_1300_cbow.bin
spa_lm	/app/data/data/spanish_lm.bin
true_en	/app/data/data/distributions.obj
true_es	/app/data/data/distributions.es.obj
true_gl	/app/data/data/distributions.gl.obj
prop_en	/app/data/data/english.myproperties.properties
prop_es	/app/data/data/spanish.myproperties.properties
prop_gl	/app/data/data/galician.myproperties.properties
corenlp_dir	/app/data/data/stanford-corenlp-full-2016-10-31
spanish_ubr	/app/data/data/spanish_dataset_ubr.txt
galician_ubr	/app/data/data/galician_dataset_ubr.txt
italian_ubr	/app/data/data/italian_dataset_ubr.txt
comp_model_en	/app/data/data/complex_classifier/en/model.pkl
comp_model_es	/app/data/data/complex_classifier/es/model.pkl
comp_model_it	/app/data/data/complex_classifier/it/model.pkl
conf_model_en	/app/data/data/confidence_model/en/model.pkl
lm_en	/app/data/data/training_full.blm.en
true_it	/app/data/data/distributions.it.obj
prop_it	/app/data/data/italian.myproperties.properties
